     ####### ######### ######### ### ##### #
    #.......#.........#.........#...#.....#.#
    #.###.###.#.#####.#.#######.###.#.#.#.#.#
    #...#.#...#...#...#...#...#...#...#.#...#
     ##.#.#.## ##.###.###.###.###.#####.###.#
    #...#.#...#.#...#...#...#.....#.....#X..#
    #.#### ##.#.###.#.#####.#.#####.#######.#
    #.#...#.......#.#.#.....#.....#.#.....#.#
    #.#.#.#.#######.#.#.#########.#.#.###.#.#
    #.#.#.....#.....#.#.#.#.......#...#.#.#.#
    #.#.#######.#####.#.#.#.#######.###.#.#.#
    #...#.....#.#.....#.#...#.....#.....#.#.#
    #.###.###.#.#.#####.#.###.#.#####.###.#.#
    #...#.#.#.#.#...#...#...#.#.#.....#...#.#
     ##.#.#.#.#.###.#.#####.#.#.#.#####.###.#
    #...#.#.#.#.#...#.#...#.#.#.......#.#...#
    #.###.#.#.#.#.###.#.###.#.#########.#.##
    #.#.#.#...#.#.#.#.#...#.#...#.......#.#.#
    #.#.#.#.###.#.#.#.###.#.#####.#######.#.#
    #.#.#.#...#.#...#...#.....#...#...#...#.#
    #.#.#.###.#.#######.#####.#.###.#.#.###.#
    #...#.#.#.#.......#.#O#...#...#.#...#...#
     ##.#.#.#.#######.#.#.#.###.#.#####.#.#.#
    #...#.#.........#.#.#.#.#...#.....#...#.#
    #.###.#########.#.#.#.#.###.#####.#####.#
    #...#...#.#...#.#.#...#...#.....#.#...#.#
     ##.###.#.#.#.#.#.#######.#####.#.#.#.#.#
    #.....#.#...#...........#.....#.#...#.#.#
    #.#####.###############.#####.#######.#.#
    #.#...#.........#...#.#.#...#.#...#...#.#
     ##.#.#########.#.#.#.#.#.#.#.#.#.#.####
    #...#...........#.#.#.#.#.#.#...#.#.#...#
    #.###.###########.#.#.#.#.#.#####.#.#.#.#
    #.#...#...........#.#...#.#.....#.#...#.#
    #.#####.###########.#.###.#####.#.#####.#
    #.#.....#.........#.#...#.#.#...#.#...#.#
    #.#.#######.#####.#.#####.#.#.###.#.#.#.#
    #...#.......#...#.#.#...#.#.#.#...#.#...#
    #.#######.###.###.#.#.#.#.#.#.#.###.###.#
    #.........#.......#...#.....#.......#...#
     ######### ####### ### ##### ####### ###